11111111
10000001
100P0001
1000C111
1E111111
11111111