1111111111111111
10001100000P0C01
1000C10000000001
1000010011100001
10C0000C00000E01
1111111111111111